WWWWWWWW
W      W
WW.WWWWW
WW.WWWWW
W..WW..W
W......W
W......W
WWWWWWWW